{
  "levels":[
    {
      "tiles":[
        [73, 73, 74,401, 72, 74, 42, 43, 43, 43, 43, 43, 43, 43, 43, 43, 43, 43, 43, 43, 43, 44, 73, 91, 91],
        [73, 73, 74,240, 72, 73, 55, 56,240,240,240, 90, 73, 91, 91, 91, 90, 73, 73, 73, 73, 73, 92, 58, 59],
        [73, 74,240,240, 72, 73, 73, 74,240, 55,240,160,160, 57,240,240,240,143, 73, 73, 73, 92, 60,240, 54],
        [73, 74,240, 54, 73, 73, 73, 74,240, 72,240,240,142,240, 54,240, 90, 90, 73, 73, 74,240,240,  6,  7],
        [73, 74,240, 90, 73, 73, 73, 74,240, 72, 74,160,160,160, 72,240,240, 72, 73, 73, 92,240,  6, 25, 44],
        [73, 74,240,240, 72, 73, 73, 92,240, 72, 74,160,160,160, 72, 56,240, 72, 73, 74,240,240, 24, 26, 54],
        [73, 73, 56,240, 90, 91, 92,240,240, 72, 74,  6,  7,  8, 72, 74,240, 90, 73, 92,240,  6, 25, 44, 72],
        [73, 73, 74,240,240,240,240,240,240, 72, 92, 24, 25, 26, 72, 92,240,240, 91,240,240, 24, 26, 54, 55],
        [ 8, 91, 91, 55, 55, 55, 55, 55, 55, 55,  6, 25, 43, 44, 72, 73, 56,240,240,240, 54, 24, 26, 72, 73],
        [25,  7,  7,  7,  7,  7,  7,  7,  7,  7, 25, 44, 54, 55, 73, 73, 92, 54, 55, 56, 72, 24, 26, 90, 91]
      ]
    },
    {
      "tiles":[
        [90,91,91,91,90,73,73,73,73,73,73,73,73,73,73,73,73,73,73,92,9,28,28,28,28],
        [401,240,240,240,72,73,73,73,73,73,73,73,73,73,73,73,73,73,92,9,28,28,28,28,50],
        [54,240,56,240,90,73,73,73,73,73,92,240,240,240,240,240,240,91,9,28,28,28,28,50,15],
        [73,240,74,240,240,73,73,73,73,92,240,240,54,55,55,56,289,289,289,28,28,28,50,15,34],
        [73,240,240,56,240,73,73,73,73,240,240,54,73,73,73,73,74,27,289,28,28,32,15,34,34],
        [73,73,240,74,240,68,143,68,92,240,54,73,73,73,73,73,74,27,289,289,289,32,15,86,86],
        [73,73,240,74,240,240, 60,86,240,240,73,73,73,73,73,73,92,27,28,28,75,289,289,181,181],
        [73,73,240,73,56,240,68,86,240,54,73,73,73,73,73,92,9,28,28,28,28,32,15,86,86],
        [240,240,240,73,74,240,240,240,240,72,73,73,73,73,92,9,28,28,28,28,28,50,33,16,16],
        [94,73,73,73,73,55,55,55,55,54,91,91,91,92,9,28,28,28,28,28,50,33,52,52,52]
      ]
    },
    {
      "tiles":[
        [34,34,36,37,19,20,34,34,34,24,25,25,44,34,34,34,34,17,6, 7, 7, 7, 7, 7, 8],
        [34,34,34,34,18,20,34,34,34,42,43,44,34,34,34,34,34,35,24,25,25,25,25,25,26],
        [34,34,34,34,36,38,34,34,34,52,52,52,52,52,52,52,52,53,24,43,43,25,25,25,26],
        [34,34,34,34,34,34,34,34,53,19,19,19,19,19,19,19,19,19,24,275,276,24,25,25,26],
        [52,52,52,52,52,52,52,53,19,289,289,289,289,289,289,289,60,289,289,293,294,24,25,25,26],
        [19,19,19,19,19,19,19,19,289,289,37,37,37,37,37,37,37,37,24,311,312,24,25,25,26],
        [401,289,289,289,289,289,289,289,289,38,6,7,7,7,7,7,7,7,25,7,7,25,25,25,26],
        [7,7,7,7,7,289,7,7,7,25,25,25,25,25,25,25,25,25,25,25,25,25,25,25,26],
        [25,25,25,25,25,143,25,25,25,25,25,25,25,25,25,25,25,25,25,25,25,25,25,25,26],
        [25,25,25,25,25,25,25,25,25,25,25,25,25,25,25,25,25,25,25,25,25,25,25,25,44]

      ]
    }
    ]
}